***********
*.........*****
*.E...........*
....*....******
*........D*
***********
-
***********
*.*.....*.*
*.........*
*.E.....E.*
*....D....*
***********
-
***********
*.........*
*..*****..*
*..*...*..*
*..E..D*..*
***********